{
    "width": 16,
    "height": 16,
    "enemies": [],
    "data": [
        " ","[","W","W","W","W","W","W","W","W","W","W","W","W","]"," ",
        " ","|"," "," "," "," "," "," "," "," "," ","X"," "," ","|"," ",
        " ","|"," "," "," "," "," "," "," "," ","X"," "," "," ","|"," ",
        " ","|"," "," "," "," ","X"," "," "," "," "," "," "," ","|"," ",
        " ","|"," "," ","K"," ","X","X","@"," "," "," "," "," ","|"," ",
        " ","|"," "," "," "," "," "," ","X"," "," "," "," "," ","|"," ",
        " ","|"," "," "," "," "," "," "," ","X"," "," "," "," ","|"," ",
        " ","|"," "," "," "," "," "," "," ","X"," "," "," "," ","|"," ",
        " ","|"," "," "," "," "," "," "," ","X"," "," "," "," ","|"," ",
        " ","{","W","W","D","W","W","W","W","W","W","W","W","W","}"," ",
        " "," "," "," "," "," "," "," "," "," "," "," "," "," "," "," ",
        " "," "," "," "," "," "," "," "," "," "," "," "," "," "," "," ",
        " "," "," "," "," "," "," "," "," "," "," "," "," ","X"," "," ",
        " "," "," "," "," "," "," "," "," "," "," "," ","X",">","X"," ",
        " "," "," "," "," "," "," "," "," "," "," "," "," ","X"," "," ",
        " "," "," ","X","X","X"," "," "," "," "," "," "," "," "," "," "
    ]
}