{
    "width": 16,
    "height": 16,
    "enemies": [
        {"name":"dude", "x":4, "y":3}
    ],
    "data": [
        " ","W","W","W","W","W","W","W","W","W","W","W","W","W","W"," ",
        " ","W","@"," "," "," "," "," "," "," "," ","X"," "," ","W"," ",
        " ","W"," "," "," "," "," "," "," "," ","X"," "," "," ","W"," ",
        " ","W"," "," "," "," ","X"," "," "," "," "," "," "," ","W"," ",
        " ","W"," "," "," "," ","X","X"," "," "," "," "," "," ","W"," ",
        " ","W"," "," "," "," "," "," ","X"," "," "," "," "," ","W"," ",
        " ","W"," "," "," "," "," "," "," ","X"," "," "," "," ","W"," ",
        " ","W","W"," "," "," ","W","W","W","W","W","W","W","W","W"," ",
        " "," "," "," "," "," "," "," "," "," "," "," "," "," "," "," ",
        " "," "," "," "," "," "," "," "," "," "," "," "," "," "," "," ",
        " "," "," "," "," "," "," "," "," "," "," "," "," "," "," "," ",
        " "," "," "," "," "," "," "," "," "," "," "," "," "," "," "," ",
        " "," "," "," "," "," "," "," "," "," "," "," "," ","X"," "," ",
        " "," "," "," "," "," "," "," "," "," "," "," ","X",">","X"," ",
        " "," "," "," "," "," "," "," "," "," "," "," "," ","X"," "," ",
        " "," "," ","X","X","X"," "," "," "," "," "," "," "," "," "," "
    ]
}