{
    "width": 16,
    "height": 16,
    "data": [
        " ","W","W","W","W","W","W","W","W","W","W","W","W","W","W"," ",
        " ","W","@"," "," "," "," "," "," "," "," "," "," "," ","W"," ",
        " ","W"," "," "," "," "," "," "," "," "," "," "," "," ","W"," ",
        " ","W"," "," "," "," "," "," "," "," "," "," "," "," ","W"," ",
        " ","W"," "," "," "," "," "," "," "," "," "," "," "," ","W"," ",
        " ","W"," "," "," "," "," "," "," "," "," "," "," "," ","W"," ",
        " ","W"," "," "," "," "," "," "," "," "," "," "," "," ","W"," ",
        " ","W","W"," "," "," ","W","W","W","W","W","W","W","W","W"," ",
        " "," "," "," "," "," "," "," "," "," "," "," "," "," "," "," ",
        " "," "," "," "," "," "," "," "," "," "," "," "," "," "," "," ",
        " "," "," "," "," "," "," "," "," "," "," "," "," "," "," "," ",
        " "," "," "," "," "," "," "," "," "," "," "," "," ","X"," "," ",
        " "," "," "," "," "," "," "," "," "," "," "," "," "," "," "," ",
        " "," "," "," "," "," "," "," "," "," "," "," ","X"," ","X"," ",
        " "," "," "," "," "," "," "," "," "," "," "," "," "," "," "," ",
        " "," "," ","X","X","X"," "," "," "," "," "," "," ","X"," "," "
    ]
}