{
  "width": 41,
  "height": 37,
  "data": [
      " ", " ", " ", " ", " ", " ", " ", " ", " ", " ", " ", " ", " ", " ", " ", " ", " ", " ", " ", " ", " ", " ", " ", " ", " ", " ", " ", " ", " ", " ", " ", " ", " ", " ", " ", " ", " ", " ", " ", " ", " ",  
      " ", " ", " ", " ", " ", " ", " ", " ", " ", " ", " ", " ", " ", " ", " ", " ", " ", " ", " ", " ", " ", " ", " ", " ", " ", " ", " ", " ", " ", " ", " ", " ", " ", " ", " ", " ", " ", " ", " ", " ", " ",  
      " ", " ", "W", "W", "W", "W", "W", "W", "W", "W", " ", " ", " ", "W", "W", "W", "W", " ", " ", " ", " ", " ", " ", " ", " ", " ", " ", " ", " ", " ", " ", " ", " ", " ", " ", " ", " ", " ", " ", " ", " ",  
      " ", " ", "W", " ", " ", " ", " ", " ", " ", "W", " ", " ", " ", "W", " ", " ", "W", " ", " ", " ", " ", " ", " ", " ", " ", " ", " ", " ", " ", " ", " ", " ", " ", " ", " ", " ", " ", " ", " ", " ", " ",  
      " ", " ", "W", " ", " ", " ", " ", " ", " ", "W", "W", "W", "W", "W", " ", "X", "W", " ", " ", " ", " ", " ", " ", " ", " ", " ", " ", " ", " ", " ", " ", " ", " ", " ", " ", " ", " ", " ", " ", " ", " ",  
      " ", " ", " ", "@", " ", "K", " ", "K", " ", "D", " ", " ", " ", "D", "K", "X", "W", " ", " ", " ", " ", " ", " ", " ", " ", " ", " ", " ", " ", " ", " ", " ", " ", " ", " ", " ", " ", " ", " ", " ", " ",  
      " ", " ", "W", " ", " ", " ", " ", " ", " ", "W", "W", "W", "W", "W", " ", " ", "W", " ", " ", " ", "W", "W", "W", "W", "W", "W", "W", "W", "W", "W", "W", "W", "W", "W", "W", "W", "W", "W", "W", "W", "W",  
      " ", " ", "W", " ", " ", " ", " ", " ", " ", "W", " ", " ", " ", "W", "W", "D", "W", " ", " ", " ", "W", " ", " ", " ", " ", " ", " ", " ", " ", " ", " ", "W", " ", " ", " ", " ", " ", " ", " ", " ", "W",  
      " ", " ", "W", " ", " ", " ", " ", " ", " ", "W", " ", " ", " ", " ", "W", " ", "W", " ", " ", " ", "W", " ", " ", " ", " ", " ", " ", " ", " ", " ", " ", "W", " ", " ", " ", " ", " ", " ", " ", " ", "W",  
      " ", " ", "W", " ", " ", " ", " ", " ", " ", "W", " ", " ", " ", " ", "W", " ", "W", " ", " ", " ", "W", " ", " ", " ", " ", " ", " ", " ", " ", " ", " ", "W", " ", " ", " ", " ", " ", " ", " ", " ", "W",  
      " ", " ", "W", "W", "W", "W", " ", "W", "W", "W", " ", " ", " ", " ", "W", " ", "W", "W", "W", "W", "W", " ", " ", " ", "X", "X", "X", " ", " ", " ", " ", "W", " ", "X", "X", "X", " ", " ", " ", " ", "W",  
      " ", " ", " ", " ", " ", " ", " ", " ", " ", " ", " ", " ", " ", " ", "W", " ", " ", " ", " ", " ", " ", " ", " ", " ", "X", "X", "X", " ", " ", " ", " ", " ", " ", "X", "X", "X", " ", " ", " ", " ", "W",  
      " ", " ", " ", " ", " ", " ", " ", " ", " ", " ", " ", " ", " ", " ", "W", " ", " ", " ", " ", " ", " ", " ", " ", " ", "X", "X", "X", " ", " ", " ", " ", " ", " ", "X", "X", "X", " ", " ", " ", " ", "W",  
      " ", " ", " ", " ", " ", " ", " ", " ", " ", " ", " ", " ", " ", " ", "W", "W", "W", "W", "W", "W", "W", " ", " ", " ", "X", "X", "X", " ", " ", " ", " ", "W", " ", "X", "X", "X", " ", " ", " ", " ", "W",  
      " ", " ", " ", " ", " ", " ", " ", " ", " ", " ", " ", " ", " ", " ", " ", " ", " ", " ", " ", " ", "W", " ", " ", " ", " ", " ", " ", " ", " ", " ", " ", "W", " ", " ", " ", " ", " ", " ", " ", " ", "W",  
      " ", " ", " ", " ", " ", " ", " ", " ", " ", " ", " ", " ", " ", " ", " ", " ", " ", " ", " ", " ", "W", " ", " ", " ", " ", " ", " ", " ", " ", " ", " ", "W", " ", " ", " ", " ", " ", " ", " ", " ", "W",  
      " ", " ", " ", " ", " ", " ", " ", " ", " ", " ", " ", " ", " ", " ", " ", " ", " ", " ", " ", " ", "W", " ", " ", " ", " ", " ", " ", " ", " ", " ", " ", "W", " ", " ", " ", " ", " ", " ", ">", " ", "W",  
      " ", " ", " ", " ", " ", " ", " ", " ", " ", " ", " ", " ", " ", " ", " ", " ", " ", " ", " ", " ", "W", " ", " ", " ", " ", " ", " ", " ", " ", " ", " ", "W", " ", " ", " ", " ", " ", " ", " ", " ", "W",  
      " ", " ", " ", " ", " ", " ", " ", " ", " ", " ", " ", " ", " ", " ", " ", " ", " ", " ", " ", " ", "W", " ", " ", " ", " ", " ", " ", " ", " ", " ", " ", "W", " ", " ", " ", " ", " ", " ", " ", " ", "W",  
      " ", " ", " ", " ", " ", " ", " ", " ", " ", " ", " ", " ", " ", " ", " ", " ", " ", " ", " ", " ", "W", " ", " ", " ", " ", " ", " ", " ", " ", " ", " ", "W", " ", " ", " ", " ", " ", " ", " ", " ", "W",  
      " ", " ", " ", " ", " ", " ", " ", " ", " ", " ", " ", " ", " ", " ", " ", " ", " ", " ", " ", " ", "W", " ", " ", " ", " ", " ", " ", " ", " ", " ", " ", "W", " ", " ", " ", " ", " ", " ", " ", " ", "W",  
      " ", " ", " ", " ", " ", " ", " ", " ", " ", " ", " ", " ", " ", " ", " ", " ", " ", " ", " ", " ", "W", "W", "W", "W", "W", "W", "W", "W", "W", "W", "W", "W", "W", "W", "W", "W", "W", "W", "W", "W", "W",  
      " ", " ", " ", " ", " ", " ", " ", " ", " ", " ", " ", " ", " ", " ", " ", " ", " ", " ", " ", " ", " ", " ", " ", " ", " ", " ", " ", " ", " ", " ", " ", " ", " ", " ", " ", " ", " ", " ", " ", " ", " ",  
      " ", " ", " ", " ", " ", " ", " ", " ", " ", " ", " ", " ", " ", " ", " ", " ", " ", " ", " ", " ", " ", " ", " ", " ", " ", " ", " ", " ", " ", " ", " ", " ", " ", " ", " ", " ", " ", " ", " ", " ", " ",  
      " ", " ", " ", " ", " ", " ", " ", " ", " ", " ", " ", " ", " ", " ", " ", " ", " ", " ", " ", " ", " ", " ", " ", " ", " ", " ", " ", " ", " ", " ", " ", " ", " ", " ", " ", " ", " ", " ", " ", " ", " ",  
      " ", " ", " ", " ", " ", " ", " ", " ", " ", " ", " ", " ", " ", " ", " ", " ", " ", " ", " ", " ", " ", " ", " ", " ", " ", " ", " ", " ", " ", " ", " ", " ", " ", " ", " ", " ", " ", " ", " ", " ", " ",  
      " ", " ", " ", " ", " ", " ", " ", " ", " ", " ", " ", " ", " ", " ", " ", " ", " ", " ", " ", " ", " ", " ", " ", " ", " ", " ", " ", " ", " ", " ", " ", " ", " ", " ", " ", " ", " ", " ", " ", " ", " ",  
      " ", " ", " ", " ", " ", " ", " ", " ", " ", " ", " ", " ", " ", " ", " ", " ", " ", " ", " ", " ", " ", " ", " ", " ", " ", " ", " ", " ", " ", " ", " ", " ", " ", " ", " ", " ", " ", " ", " ", " ", " ",  
      " ", " ", " ", " ", " ", " ", " ", " ", " ", " ", " ", " ", " ", " ", " ", " ", " ", " ", " ", " ", " ", " ", " ", " ", " ", " ", " ", " ", " ", " ", " ", " ", " ", " ", " ", " ", " ", " ", " ", " ", " ",  
      " ", " ", " ", " ", " ", " ", " ", " ", " ", " ", " ", " ", " ", " ", " ", " ", " ", " ", " ", " ", " ", " ", " ", " ", " ", " ", " ", " ", " ", " ", " ", " ", " ", " ", " ", " ", " ", " ", " ", " ", " ",  
      " ", " ", " ", " ", " ", " ", " ", " ", " ", " ", " ", " ", " ", " ", " ", " ", " ", " ", " ", " ", " ", " ", " ", " ", " ", " ", " ", " ", " ", " ", " ", " ", " ", " ", " ", " ", " ", " ", " ", " ", " ",  
      " ", " ", " ", " ", " ", " ", " ", " ", " ", " ", " ", " ", " ", " ", " ", " ", " ", " ", " ", " ", " ", " ", " ", " ", " ", " ", " ", " ", " ", " ", " ", " ", " ", " ", " ", " ", " ", " ", " ", " ", " ",  
      " ", " ", " ", " ", " ", " ", " ", " ", " ", " ", " ", " ", " ", " ", " ", " ", " ", " ", " ", " ", " ", " ", " ", " ", " ", " ", " ", " ", " ", " ", " ", " ", " ", " ", " ", " ", " ", " ", " ", " ", " ",  
      " ", " ", " ", " ", " ", " ", " ", " ", " ", " ", " ", " ", " ", " ", " ", " ", " ", " ", " ", " ", " ", " ", " ", " ", " ", " ", " ", " ", " ", " ", " ", " ", " ", " ", " ", " ", " ", " ", " ", " ", " ",  
      " ", " ", " ", " ", " ", " ", " ", " ", " ", " ", " ", " ", " ", " ", " ", " ", " ", " ", " ", " ", " ", " ", " ", " ", " ", " ", " ", " ", " ", " ", " ", " ", " ", " ", " ", " ", " ", " ", " ", " ", " ",  
      " ", " ", " ", " ", " ", " ", " ", " ", " ", " ", " ", " ", " ", " ", " ", " ", " ", " ", " ", " ", " ", " ", " ", " ", " ", " ", " ", " ", " ", " ", " ", " ", " ", " ", " ", " ", " ", " ", " ", " ", " ",  
      " ", " ", " ", " ", " ", " ", " ", " ", " ", " ", " ", " ", " ", " ", " ", " ", " ", " ", " ", " ", " ", " ", " ", " ", " ", " ", " ", " ", " ", " ", " ", " ", " ", " ", " ", " ", " ", " ", " ", " ", " "
    ]
}